NO imgs/wall_s.xpm  
SO imgs/wall_w.xpm
WE imgs/stone2.xpm
EA imgs/wall_s.xpm

F 234,230,245
C 100,30,0

1111111111111111 1111
1000111000000001 1001
1000100000111111 1001
10001110001      1111
10000000W01
11111111111