NO imgs/wall_s.xpm  
SO imgs/wall_w.xpm
WE imgs/stone2.xpm
EA imgs/wall_s.xpm

F 234,230,245
C 100,30,0

1111111111111
1000111000001
1000100000001
1000111110001
1000000000001
10000000W0001
1000000000001
1111111111111