NO imgs/wall_s.xpm
SO imgs/wall_s.xpm
WE imgs/wall_s.xpm
EA imgs/wall_s.xpm

F 0,40,300
C 225,30,0

11111111111	1111111111111111
10000000001	1000000000000001
10110000011	1000000000010001
10010000001	1000000000000001
10110000011011111100000010011111
10000000001000000111011110000001
11110111111111011100000010000001
11110111111111011101010010000001
11000000111111111100000010000001
1T0000001     101100000010000001
100000001     101100010000000001
1100T000111   110000000000000001
1111D111111   100000000000000001
100000000T1111100100000010000001
10000000000000000000000001000001
100000N0001000010000000001000001
1T00K00T001101000000000000000001
10000000000100000001010000000001
11111111111111111111111111111111

