NO imgs/wall_s.xpm  
SO imgs/wall_w.xpm
WE imgs/stone2.xpm
EA imgs/wall_s.xpm

F 234,230,245
C 100,30,0

11111111111	1111111111111111  11111
10000000001	1000000000000001  10001
10110000011 1000000000010001  10001
10010000001	1000000000000001  11111
1011000001101111110000001001
10000000001000000111011110011111
11110111111111011100000010000001
11110111111111011101010010000001  
1100000011111111110000001000000111111
1000000000000000000000000000000000001
1T00000011111111011000000100000011111
100000001     101100010000000001
11000000111   110000000000000001
1111D111111   100000000000000001
100000100T1111100110000010000000        1111111111111111111111
10000000000000000000000111000001        1100000000000000001001
10000000001000010000000001000001        11000000N0000000000011
1T00K00T001101000000000000000001        1111111111011111111111
10000000000100000001010000000001                1001
11111111111111111111111111111111                1001
                                                1001
                                                1001
    111111111111111111111111111111111111111111111001
    100000000000000000000000000000000000000000000001
    111111111111111111111111111111111111111111111111