NO ./path_to_the_north_texture_no
SO ./path_to_the_south_texture_so
WE ./path_to_the_west_texture_we
EA ./path_to_the_east_texture_ea

F 242,250,239
C 242,250,239

11111111111	1111111111111111
10000000001	1000000000000001
10110000011	1000000000010001
10010000001	1000000000000001
10110000011111111000000010000001
10000000001100000111011110000001
11110111111111011100000010000001
11110111111111011101010010000001
11000000111111111100000010000001
1T0000000     101100000010000001
100000001     101100010000000001
1100T000111   110000000000000001
1111D111111   100000000000000001
100000000T1111100100000010000001
1000000000000000000000I001000001
1000000000100N010000000001000001
1T00K00T001101000000000000000001
10000000000100000001010000000001
11111111111111111111111111111111

