NO ./path_to_the_north_texture_no
SO ./path_to_the_south_texture_so
WE ./path_to_the_west_texture_we
EA ./path_to_the_east_texture_ea

F 255, 127, 80
C 222, 184, 135

11111111111111111111111111111111
10000000000000000000000000000001
10000000000000000000000000000001
10000000000000000000000000000001
10000000000000000000000000000001
10000000000000000000000000000001
10000000000000000000000000000001
10000000000000N00000000000000001
10000000000000000000000000000001
10000000000000000000000000000001
1000000000000000000T000000000001
10000000000000000000000000000001
10000000000000000000000000000001
10000000000000000000000000000001
11111111111111111111111111111111

