NO imgs/wall_s.xpm  
SO imgs/wall_w.xpm
WE imgs/stone2.xpm
EA imgs/wall_s.xpm

F 234,230,245
C 100,30,0


1111111111
10N0001001
1000001001
1000001001
1111111111

