NO ./path_to_the_north_texture_no
SO ./path_to_the_south_texture_so
WE ./path_to_the_west_texture_we
EA ./path_to_the_east_texture_ea

F 0,40,300
C 225,30,0

111111111111111
100001000000001
100001000000001
100001000000001
100001000000001
1000000N0001001
111100000001001
100000000001001
111111111111111

