NO imgs/wall_s.xpm
SO imgs/wall_s.xpm
WE imgs/wall_s.xpm
EA imgs/wall_s.xpm

F 0,40,300
C 225,30,0

1111111111111
1K000N0000001
1111111111111

